#######################################
#........R..........TTT..NT....R......#
#........R...........TTT.TT...........#
#....T...R.....C......................#
#....T................R...............#
#....TTTTTT.........WWR...............#
#....T...............WWWWWW......O....#
#..MCR................WWC.W......W....#
#..RRR...............WWWWM............#
#........................T............#
#................R....................#
#...........RR.M.RR......T............#
#............R...RR..........R........#
#H...............R...........RNC......#
#######################################
